zinc_plate	forge:plates	forge:plates/zinc
lead_plate	forge:plates	forge:plates/lead
gold_plate	forge:plates	forge:plates/gold
netherite_plate	forge:plates	forge:plates/netherite
steel_plate	forge:plates	forge:plates/steel
nickel_plate	forge:plates	forge:plates/nickel
monel_plate	forge:plates	forge:plates/monel
palladium_plate	forge:plates	forge:plates/palladium
aluminum_plate	forge:plates	forge:plates/aluminum
tungsten_plate	forge:plates	forge:plates/tungsten
tin_plate	forge:plates	forge:plates/tin
iron_plate	forge:plates	forge:plates/iron
copper_plate	forge:plates	forge:plates/copper
silver_plate	forge:plates	forge:plates/silver
brass_plate	forge:plates	forge:plates/brass
redstone_alloy_plate	forge:plates	forge:plates/redstone_alloy
raw_zinc	forge:raw_materials	forge:raw_materials/zinc
raw_lead	forge:raw_materials	forge:raw_materials/lead
raw_nickel	forge:raw_materials	forge:raw_materials/nickel
raw_palladium	forge:raw_materials	forge:raw_materials/palladium
raw_tin	forge:raw_materials	forge:raw_materials/tin
raw_silver	forge:raw_materials	forge:raw_materials/silver
zinc_nugget	forge:nuggets	forge:nuggets/zinc
lead_nugget	forge:nuggets	forge:nuggets/lead
steel_nugget	forge:nuggets	forge:nuggets/steel
nickel_nugget	forge:nuggets	forge:nuggets/nickel
monel_nugget	forge:nuggets	forge:nuggets/monel
palladium_nugget	forge:nuggets	forge:nuggets/palladium
aluminum_nugget	forge:nuggets	forge:nuggets/aluminum
tungsten_nugget	forge:nuggets	forge:nuggets/tungsten
tin_nugget	forge:nuggets	forge:nuggets/tin
silver_nugget	forge:nuggets	forge:nuggets/silver
brass_nugget	forge:nuggets	forge:nuggets/brass
redstone_alloy_nugget	forge:nuggets	forge:nuggets/redstone_alloy
zinc_ingot	forge:ingots	forge:ingots/zinc
lead_ingot	forge:ingots	forge:ingots/lead
steel_ingot	forge:ingots	forge:ingots/steel
nickel_ingot	forge:ingots	forge:ingots/nickel
monel_ingot	forge:ingots	forge:ingots/monel
palladium_ingot	forge:ingots	forge:ingots/palladium
aluminum_ingot	forge:ingots	forge:ingots/aluminum
tungsten_ingot	forge:ingots	forge:ingots/tungsten
tin_ingot	forge:ingots	forge:ingots/tin
silver_ingot	forge:ingots	forge:ingots/silver
brass_ingot	forge:ingots	forge:ingots/brass
redstone_alloy_ingot	forge:ingots	forge:ingots/redstone_alloy
zinc_dust	forge:dusts	forge:dusts/zinc
lead_dust	forge:dusts	forge:dusts/lead
gold_dust	forge:dusts	forge:dusts/gold
stone_dust	forge:dusts	forge:dusts/stone
blackstone_dust	forge:dusts	forge:dusts/blackstone
netherite_dust	forge:dusts	forge:dusts/netherite
netherrack_dust	forge:dusts	forge:dusts/netherrack
steel_dust	forge:dusts	forge:dusts/steel
nickel_dust	forge:dusts	forge:dusts/nickel
monel_dust	forge:dusts	forge:dusts/monel
palladium_dust	forge:dusts	forge:dusts/palladium
aluminum_dust	forge:dusts	forge:dusts/aluminum
tungsten_dust	forge:dusts	forge:dusts/tungsten
tin_dust	forge:dusts	forge:dusts/tin
iron_dust	forge:dusts	forge:dusts/iron
copper_dust	forge:dusts	forge:dusts/copper
silver_dust	forge:dusts	forge:dusts/silver
brass_dust	forge:dusts	forge:dusts/brass
redstone_alloy_dust	forge:dusts	forge:dusts/redstone_alloy
spo_zinc_dust	forge:tiny_dusts	forge:tiny_dusts/zinc
spo_lead_dust	forge:tiny_dusts	forge:tiny_dusts/lead
spo_gold_dust	forge:tiny_dusts	forge:tiny_dusts/gold
spo_netherite_dust	forge:tiny_dusts	forge:tiny_dusts/netherite
spo_steel_dust	forge:tiny_dusts	forge:tiny_dusts/steel
spo_nickel_dust	forge:tiny_dusts	forge:tiny_dusts/nickel
spo_monel_dust	forge:tiny_dusts	forge:tiny_dusts/monel
spo_palladium_dust	forge:tiny_dusts	forge:tiny_dusts/palladium
spo_aluminum_dust	forge:tiny_dusts	forge:tiny_dusts/aluminum
spo_tungsten_dust	forge:tiny_dusts	forge:tiny_dusts/tungsten
spo_tin_dust	forge:tiny_dusts	forge:tiny_dusts/tin
spo_iron_dust	forge:tiny_dusts	forge:tiny_dusts/iron
spo_copper_dust	forge:tiny_dusts	forge:tiny_dusts/copper
spo_silver_dust	forge:tiny_dusts	forge:tiny_dusts/silver
spo_brass_dust	forge:tiny_dusts	forge:tiny_dusts/brass
spo_redstone_alloy_dust	forge:tiny_dusts	forge:tiny_dusts/redstone_alloy
